###############################
#.............................#
#.............#...............#
#.............#...............#
#.............#...............#
#.............#...............#
#.............#...............#
#.............#...............#
#.............#...............#
#.............#...............#
#.............#...............#
#.............#...............#
#.............#...............#
#.............#...............#
#.............#...............#
#.............#...............#
#.............#...............#
#.............#...............#
#.............#...............#
#.............#...............#
###############################
